11111111111111111111
1C0EP111C00000000001
10000000001111000001
10000000000000000001
100000011000000C0001
11111111111111111111
